[mon0]
y = 61
x = 244
[mon1]
y = 464
x = 906
[mon2]
y = 635
x = 822
[mon3]
y = 63
x = 252
[mon4]
y = 61
x = 252
[mon5]
y = 63
x = 252
[mon6]
y = 505
x = 782
[mon7]
y = 62
x = 252
[mon8]
y = 71
x = 237
[mon9]
y = 170
x = 891
[level]
map = '''777777777777777777777677777777
    777777777777777777777767777777
    777777777777777777776776777777
    777777777777777777776776777777
    777777777777777777776776777777
    777777777777777777776666777777
    777777777777777777777776777777
    777777777777777777777776777777
    777777777777777777777776777777
    777777777777777777777777777777
    777777777777777777777777777777
    777777777777777777777777777777
    777777777777777777777777777777
    777777777777777777777777777777
    777777777777777777777777777777
    777777777777777777777777777777
    777777777777777777777777777777
    777777777777777777777777777777
    777777777777777777777777777777
    777777777777777777777777777777
    777777777777777777777777777777
    777777777777777777777777777777
    777777777777777777777777777777
    777777777777777777777777777777
    777777777777777777777777777777
    777777777777777777777777777777
    777777777777777777777777777777
    777777777777777777777777777777
    777777777777777777777777777777
    777777777777777777777777777777
    777777777777777777777777777777
    777777777777777777777777777777
    777777777777777777777777777777
    777777777777777777777777777777
    777777777777777777777777777777
    777777777777777777777777777777
    777777777777777777777777777777
    777777777777777777777777777777
    777777777777777777777777777777
    777777777777777777777777777777
    777777777777777777777777777777
    
    '''
tileset = abc


[d]
name = door
tile = 1, 4

[1]
name = wall
tile = 1, 1

[2]
name = wall
tile = 2, 1

[3]
name = wall
tile = 3, 1

[4]
name = wall
tile = 4, 1

[5]
name = pool
tile = 1, 2

[6]
name = wall
tile = 2, 2

[7]
name = floor
tile = 3, 2

[8]
name = wall
tile = 4, 2

[9]
name = wall
tile = 1, 3

[0]
name = wall
tile = 2, 3