[level]
map = '''777777777777777777777777777777
    777777777777777777777777777777
    777777777777777777777777777777
    777777777777777777777777777777
    777777777777777777777777777777
    777777777777777777777777777777
    777777777777777777717777777777
    777777777777777171777777777777
    777777777777111177777777777777
    777777777777711177777777777777
    777777777777177777777777777777
    777777777777777777777777777777
    777777777777777777777777777777
    777777777777777777777777777777
    777777777777117777777777777777
    77777777777qq17777777777777777
    77777777777q117777777777777777
    77777777777qqq1777777777777777
    777777777777717777777777777777
    777777777717777777777777777777
    777777777777777777777777777777
    777777777777777777777777777777
    777777777777777777777777777777
    777777777777777777777777777777
    777777777777777777777777777777
    777777777777777777777777777777
    777777777777777777777777777777
    777777777777777777777777777777
    777777711777777777777777777777
    777777777777777777777777777777
    777777777777777777777777777777
    777777777777777777777777777777
    777777777777777177777777777777
    777777777777777777171777777777
    777777777777777771117777777777
    777777777777777711777777777777
    777777777777777711777777777777
    777777777777777777733777777777
    777777777777777777733777777777
    777777777777777777777777777777
    777777777777777777777777777777
    
    '''
tileset = abc

[1]
name = wall
tile = 1, 1

[2]
name = wall
tile = 2, 1

[3]
name = wall
tile = 3, 1

[4]
name = wall
tile = 4, 1

[q]
name = pool
tile = 4, 8

[5]
name = wall
tile = 1, 2

[6]
name = wall
tile = 2, 2

[7]
name = floor
tile = 3, 2

[8]
name = wall
tile = 4, 2

[9]
name = wall
tile = 1, 3

[0]
name = wall
tile = 2, 3