[mon0]
y = 514
x = 782
[mon1]
y = 167
x = 324
[mon2]
y = 411
x = 246
[mon3]
y = 608
x = 487
[mon4]
y = 679
x = 583
[mon5]
y = 710
x = 511
[mon6]
y = 292
x = 182
[mon7]
y = 505
x = 918
[mon8]
y = 271
x = 182
[mon9]
y = 164
x = 918
[level]
map = '''777777777777777777777777777777
    111111577777777777777777777777
    177777177777777777799999993333
    177777177777777777797777797773
    177777177777777766697168797773
    177777177777777767797234793377
    177777555555555557797777797773
    177777177775777767799999997773
    177777177775777767777777777373
    777777177775777767777777663733
    777777177775777767777777637773
    555555555555777767777777637773
    444544444475777767777777637773
    477777774475777767777777637773
    477777774475777767777777637773
    477777774475777744455544437773
    477777774475777744455544437773
    477777774475777777755577737773
    477777775555555555555555555733
    477777774477777757777777773737
    477777774477777757777777773737
    477777774477777757788888888737
    477777774477777755557777777737
    444444444477777777187777778337
    777777777777777777287888878777
    777777777777777777387778778777
    777777777777777777487778778777
    777777777777777777587878778777
    777777777777777777687787778777
    777777777777777777787777778777
    777777777777777777788888888777
    777777777777777777777777777777
    777777777777777777777777777777
    777777777777777777777777777777
    777777777777777777777777777777
    777777777777777777777777777777
    777777777777777777777777777777
    777777777777777777777777777777
    777777777777777777777777777777
    777777777777777777777777777777
    777777777777777777777777777777
    
    '''
tileset = abc


[d]
name = door
tile = 1, 4

[1]
name = wall
tile = 1, 1

[2]
name = wall
tile = 2, 1

[3]
name = wall
tile = 3, 1

[4]
name = wall
tile = 4, 1

[5]
name = pool
tile = 1, 2

[6]
name = wall
tile = 2, 2

[7]
name = floor
tile = 3, 2

[8]
name = wall
tile = 4, 2

[9]
name = wall
tile = 1, 3

[0]
name = wall
tile = 2, 3