[level]
map = '''777777777777777777777777777777
    111111577777777777777777777777
    177777177777777777799999993333
    177777177777777777797777797773
    177777177777777766697168797773
    177777177777777767797234797773
    177777555555555557797777797773
    177777177775777767799999997773
    177777177775777767777777777773
    177777177775777767777777667773
    177777177775777767777777637773
    111511177775777767777777637773
    444544444475777767777777637773
    477777774475777767777777637773
    477777774475777767777777637773
    477777774475777744455544437773
    477777774475777744455544437773
    477777774475777777755577737773
    477777775555555555555555555733
    477777774477777757777777773737
    477777774477777757777777773737
    477777774477777757788888888737
    477777774477777755557777777737
    444444444477777777787777778337
    777777777777777777787888878777
    777777777777777777787778778777
    777777777777777777787778778777
    777777777777777777787878778777
    777777777777777777787787778777
    777777777777777777787777778777
    777777777777777777788888888777
    777777777777777777777777777777
    777777777777777777777777777777
    777777777777777777777777777777
    777777777777777777777777777777
    777777777777777777777777777777
    777777777777777777777777777777
    777777777777777777777777777777
    777777777777777777777777777777
    777777777777777777777777777777
    777777777777777777777777777777
    
    '''
tileset = abc


[d]
name = door
tile = 1, 4

[1]
name = wall
tile = 1, 1

[2]
name = wall
tile = 2, 1

[3]
name = wall
tile = 3, 1

[4]
name = wall
tile = 4, 1

[5]
name = pool
tile = 1, 2

[6]
name = wall
tile = 2, 2

[7]
name = floor
tile = 3, 2

[8]
name = wall
tile = 4, 2

[9]
name = wall
tile = 1, 3

[0]
name = wall
tile = 2, 3