[level]
map = '''777777777776777777777777777777
    177111111111111111117777777777
    177111177717777777777777777777
    577111177777777777777777777777
    177777171117777711111111777777
    177777111111777717777771777777
    177777555555555557777771777777
    177777111111777717777771777777
    166771777111777717777771777777
    777771111177777766655666777777
    777777777777777767777776666677
    777777777777777767777777777677
    777777777777777767777777777677
    777777777777777767777777777677
    777777777777777766665666777677
    777777777777777777777776777577
    677777767777777777777776777577
    677777777777777777777776777677
    677777767777777777777776777677
    676777777777777776777776666677
    677777777777776777777777777777
    676777777777777777777776677777
    776777777777777777777777777777
    676777777777777767767777777777
    676777777777777777777777777777
    676777777777777777776767777777
    776777777777777777777777777777
    777777777777777777777776777777
    777777777777777777777677777777
    666677777777777777777777777777
    777777777777777777777767776676
    777777777777777777777777776777
    777777777777777777777777776776
    777777777777777777777777777777
    777777777777777777777777777777
    777777777777777777777777777767
    777777777777777777777777777777
    777777777777777777777777777777
    777777777777777777777777777777
    777777777777777777777777777777
    777777777777777777777777777777
    
    '''
tileset = abc


[d]
name = door
tile = 1, 4

[1]
name = wall
tile = 1, 1

[2]
name = wall
tile = 2, 1

[3]
name = wall
tile = 3, 1

[4]
name = wall
tile = 4, 1

[5]
name = pool
tile = 1, 2

[6]
name = wall
tile = 2, 2

[7]
name = floor
tile = 3, 2

[8]
name = wall
tile = 4, 2

[9]
name = wall
tile = 1, 3

[0]
name = wall
tile = 2, 3