[level]
map = '''777777777777777777777777777777
    777777777777777777777777777777
    777777777777777777777777777777
    777777777777777777777777777777
    777777777777777777777777777777
    777777777777777777777777777777
    777777777777777777777777777777
    777777777777777777777777777777
    777777777777777777777777777767
    777777777777777777777777776766
    777777777777777777777777777777
    777777777777777777777777777777
    777777777777777777777777777777
    777777777777777777777777777777
    777777777777777777777777777777
    777777777777777777777777777777
    777777777777777777777777777777
    777777777777777777777777777777
    777777777777777777777777777777
    777777777777777777777777777777
    777777777777777777777777777777
    777777777777777777777777777777
    777777777777777777777777777777
    777777777777777777777777777777
    777777777777777777777777777777
    777777777777777777777777777777
    777777777777777777777777777777
    777777777777777777777777777777
    777777777777777777777777777777
    777777777777777777777777777777
    777777777777777777777777777777
    777777777777777777777777777777
    777777777777777777777777777777
    777777777777777777777777777777
    777777777777777777777777777777
    777777777777777777777777777777
    777777777777777777777777777777
    777777777777777777777777777777
    777777777777777777777777777777
    777777777777777777777777777777
    777777777777777777777777777777
    
    '''
tileset = abc


[d]
name = door
tile = 1, 4

[1]
name = wall
tile = 1, 1

[2]
name = wall
tile = 2, 1

[3]
name = wall
tile = 3, 1

[4]
name = wall
tile = 4, 1

[5]
name = pool
tile = 1, 2

[6]
name = wall
tile = 2, 2

[7]
name = floor
tile = 3, 2

[8]
name = wall
tile = 4, 2

[9]
name = wall
tile = 1, 3

[0]
name = wall
tile = 2, 3